{
	"tileset" : "1.png",
	"terrain" : [
		[1,1,1,1,1,1,1,1,1],
                [1,1,1,1,1,1,1,1,1],
                [1,1,1,1,1,1,1,1,1],
                [1,1,1,1,1,1,1,1,1],
                [1,1,1,1,1,1,1,1,1],
                [1,1,1,1,1,1,1,1,1],
                [1,1,1,1,1,1,1,1,1],
                [1,1,1,1,1,1,1,1,1],
                [1,1,1,1,1,1,1,1,1],
                [1,1,1,1,1,1,1,1,1],
                [1,1,1,1,1,1,1,1,1],
                [1,1,1,1,1,1,1,1,1]

	],

        "etage1" : [
		[41,42,43,44,1,1,1,1,1],
                [49,50,51,52,1,498,1,1,1],
                [57,58,59,60,1,1,1,1,1],
                [65,66,67,68,1,1,510,511,1],
                [73,74,75,76,1,1,1,1,1],
                [1,1,1,1,1,1,1,1,1],
                [1,1,517,1,1,1,1,1,498],
                [1,1,1,1,1,1,1,1,1],
                [1,1,1,1,1,1,513,514,514],
                [1,1,1,1,498,1,521,522,522],
                [1,498,1,1,1,1,529,532,522],
                [1,498,1,1,1,1,1,521,522]
	]
}
